11111111111111111111111111111111111111111111111111111111111111111111111111111111111111111111111111111111111111111111
1E0000C0001111000C00000C00000000000000011110000000000000111100000000000011111110000000000111110001111000010000000001
10110110100100000101001000C00001111100000000000000000000000000001111110000000000000000000000000000000000000000010101
10000000000000000000000000000000000000000000000000000000000000000000000000000000000000000000000000000000000000000001
10110110100100000101001000C00000000000000000000000000000000000000000000000000000000000000000000000000000000000010111
10110110P00100000101001000C0000000000000000011111000000000C01CC11101010111111000000011111110000001000000000000000001
1011011010010X000101001000C0001100000101001010101010010C1C01C01010100000000111000010101CCCCC010000000001110000000001
10000000000000000001101101001000000000000000000000000000000000000000000000000000000000000000000000000000000000011111
10000XC0000001010010000010100000000000000000000000X010100100000101000000000010X0101001000001010000000000000011111111
10110110100100000101001000C00000101000011111000000000000000000000000000000000000000000000000000000000000011111111111
10000000000000000000000000000000000000000000000000000000000000000000000000000000000000000000000000000000000000000001
10110110100100000101001000C00000000000000000000000000000000000000000000000000000000000000000000000000001100100000011
10110110100100000101001000C000000000101001010101010010C1C01C01010100000000111000010101C00000000000000000001000001011
10110110100100000101001000C00000000000000000000000000000000000000000000000000000000000000000000000010000000000001011
1011000C0000011111001111000000000000000110000000000000000000110100100X001010010110100100X001010010100000011110001011
1000000111111000000000000000010X010100100000101001000C000000000000010X0101001000001010010000001110001000000000001011
10000000000000000000000000000000000000000000000000000000000000000000000000000000000000000000000000000000000000000001
11111111111111000000000000000000000110110100100000101001000C0000000000000101001010101010010C1C01C0101010000000000001
1000000000100000101001000C000000000000000000000000000000000000000000000000000000000000000000000000000000000000000111
10110110100100000101001000C0000001010101010010C1C01C0000000000000000000000000000000000000000000000000000000000111111
10000000000000110110100100000101001000C00000000000000000000000000000000000000110110100100000101001000C00000000000011
10110110100100X00101001000C00000000001111100000000000000000000000000011001010111111100000000001111000000000000000011
10110110100100000101001000C00000000000000000000000000000000000000000000000000000000000000000000000000000000000000011
100000000000000000000000010X01010010000000000000000001010010C1C01C00000000000000000000000000011111111111111111111111
101000000000000000000000000000001000C0000000000000000000000000000000000000000000000000000000000000000000000000000001
100000000000000000000000000000000000000000000000000110110100100XX0101001000C0001010101111111010100000000000000000001
100000000000000000000000000000010C1C01C001000C0000000000000000000000000000000000000000000000000000000000000000000001
101000C0000000000000000000000000000000000000000000001101101001000001010000000000000000000000000000000000000000000001
101100000000000000000000000000000X00101001000C0000000000000000000000000000101010101011111111010100000000000000000001
1011000000000000000000000000000000101001000C00000000000010000C00000000000001000C000000001000C01000C01000C01000C01001
10111111110010000000000000000000000000101000000000000100000000000000000000000000010111000000000000000000000000000001
100001111000011010001001000001100000000000000001110110101111110001011000000000010101010101111111111000010000000000C1
11111111111111111111111111111111111111111111111111111111111111111111111111111111111111111111111111111111111111111111