1111111111111
10001E0000C01
1P11010111001
100X0000X0001
110X00X0X0001
110X0000X0001
110X0000X0001
110X0000X0001
1111111111111