1111111111111
10010000010C1
1000011111001
1P0000E10X001
1111111111111