1111111111111
1111111CEP111
1111111111111