1111111111111
10010000000C1
1000011111001
1P0011E00X001
1111111111111