1111111111111111111111111111111111
1E0001C00100000C00000C000000000101
10111110100100000101001000C0001011
1111111111101010001001000000010111
1P0000000C00C00000000X0000000001C1
1111111111111111111111111111111111