1111111111111111111111111111111111
1E0000C00000000C00000C000000000101
10110110100100000101001000C0001011
10110110100100000101001000C0001011
10110110100100000101001000C0001011
10110110100100000101001000C0001011
1011011010010X000101001000C0001011
10110110100100000101001000C0001011
1010X010100100000101001000C0001011
10110110100100000101001000C0001011
10110110100100XX0101001000C0001011
10110110100100000101001000C0001011
10110110100100000101001000C0001011
10110110100100000101001000C0X01011
10110110100100X00101001000C0001011
10110110100100000101001000C0001011
10110110100100000101001000C0001011
1000011111110100010010000000101111
1P0000000C00C0000000000000000000C1
1111111111111111111111111111111111