1111111111111
1PE0111111111
1111111111111