1111111111111
1P0C111111111
1111111111111