1111111111111
10EC111111111
1111111111111