1111111111111
1PEC111111111
1111111111111